// The nouns in this list were taken from the following site and represent the most commonly used ones
// http://www.memrise.com/course/131111/5000-most-common-french-words-2/
abandon	m
abbé	m
abord	m
aboutissement	m
abri	m
absence	f
abus	m
accélération	f
accent	m
acceptation	f
accès	m
accessoire	m
accident	m
accord	m
accroissement	m
accueil	m
accumulation	f
accusation	f
achat	m
acheminement	m
acheteur	m
acide	m
acier	m
acquisition	f
acte	m
acteur	m
action	f
activité	f
actualité	f
adaptation	f
adhésion	f
adjoint	m
administrateur	m
administration	f
admiration	f
adolescent	m
adoption	f
adresse	f
aéroport	m
affaiblissement	m
affaire	f
affectation	f
affection	f
affiche	f
affirmation	f
affrontement	m
âge	m
agence	f
agenda	m
agent	m
agitation	f
agression	f
agriculteur	m
agriculture	f
aide	f
aile	f
air	m
aire	f
aise	f
ajustement	m
alarme	f
album	m
alcool	m
alerte	f
aliment	m
alimentation	f
allée	f
allégement	m
alliance	f
allocation	f
allure	f
allusion	f
alternative	f
altitude	f
amant	m
ambassade	f
ambassadeur	m
ambiance	f
ambiguïté	f
ambition	f
âme	f
amélioration	f
aménagement	m
amende	f
amendement	m
ami	m
amitié	f
amour	m
ampleur	f
an	m
analyse	f
ange	m
angle	m
angoisse	f
animal	m
animateur	m
année	f
anniversaire	m
annonce	f
annulation	f
antenne	f
aperçu	m
appareil	m
apparence	f
apparition	f
appartement	m
appartenance	f
appel	m
application	f
apport	m
appréciation	f
apprentissage	m
approbation	f
approche	f
approvisionnement	m
appui	m
aptitude	f
arbitrage	m
arbre	m
architecture	f
argent	m
argument	m
arme	f
armée	f
armement	m
arrangement	m
arrestation	f
arrêt	m
arrêté	m
arrivant	m
arrivée	f
art	m
article	m
artisan	m
asile	m
aspect	m
aspiration	f
assassin	m
assassinat	m
assaut	m
assemblée	f
assiette	f
assise	f
assistance	f
assistant	m
association	f
assurance	f
atelier	m
atmosphère	f
atout	m
attachement	m
attaque	f
atteinte	f
attentat	m
attente	f
attention	f
attitude	f
attribution	f
aube	f
audience	f
auditeur	m
audition	f
augmentation	f
auto	f
autobus	m
automne	m
automobile	f
autonomie	f
autorisation	f
autorité	f
autoroute	f
aval	m
avalanche	f
avance	f
avancée	f
avantage	m
avenir	m
aventure	f
avenue	f
avertissement	m
aveu	m
aviation	f
avion	m
avis	m
avocat	m
axe	m
bagage	m
baie	f
bain	m
baisse	f
balance	f
balle	f
ballon	m
banc	m
bande	f
banlieue	f
banque	f
banquier	m
bar	m
barrage	m
barre	f
barreau	m
barrière	f
base	f
bassin	m
bataille	f
bateau	m
bâtiment	m
bâton	m
batterie	f
bavardage	m
beauté	f
bébé	m
bénéfice	m
besoin	m
bétail	m
bête	f
béton	m
beurre	m
biais	m
bibliothèque	f
bière	f
bijou	m
bilan	m
bille	f
billet	m
blague	f
blé	m
blessure	f
bloc	m
blocage	m
bois	m
boisson	f
boîte	f
bombardement	m
bombe	f
bond	m
bonheur	m
bord	m
bordel	m
borne	f
bouche	f
boucher	m
boucle	f
boue	f
bouf	m
bougie	f
boule	f
boulevard	m
bouleversement	m
boulot	m
bourgeois	m
bourse	f
boursier	m
bout	m
bouteille	f
boutique	f
bouton	m
branche	f
brebis	f
brèche	f
brigade	f
brillant	m
brouillard	m
bruit	m
budget	m
bulle	f
bulletin	m
bureau	m
bus	m
but	m
cabine	f
cabinet	m
câble	m
cadavre	m
cadeau	m
cadre	m
café	m
cage	f
cahier	m
caisse	f
calcul	m
calendrier	m
caméra	f
camion	m
camp	m
campagne	f
canal	m
cancer	m
candidat	m
candidature	f
canon	m
cap	m
capacité	f
capitaine	m
capitale	f
capitalisme	m
caractère	m
caractéristique	f
carafe	f
carburant	m
carnet	m
carrière	f
carte	f
carton	m
cas	m
case	f
casque	m
cassette	f
catastrophe	f
catégorie	f
cauchemar	m
cause	f
caution	f
cave	f
cédille	f
ceinture	f
cellule	f
censure	f
cent	m
centaine	f
centrale	f
centre	m
cercle	m
céréale	f
cérémonie	f
certificat	m
certitude	f
cerveau	m
cessez-le-feu	m
chagrin	m
chaîne	f
chair	f
chaise	f
chaleur	f
chambre	f
champ	m
champion	m
championnat	m
chance	f
chancelier	m
change	m
changement	m
chanson	f
chant	m
chanteur	m
chantier	m
chaos	m
chapeau	m
chapitre	m
char	m
charbon	m
charge	f
charité	f
charme	m
charte	f
chasse	f
chasseur	m
chat	m
château	m
chauffeur	m
chaussure	f
chef	m
chemin	m
chemise	f
chenille	f
chèque	m
chercheur	m
cheval	m
cheveu	m
cheville	f
chien	m
chiffre	m
chimie	f
chirurgien	m
choc	m
chocolat	m
choix	m
chômage	m
chômeur	m
chose	f
chronique	f
chute	f
cible	f
ciel	m
cigarette	f
cimetière	m
cinéma	m
cinquantaine	f
circonscription	f
circonstance	f
circuit	m
circulation	f
cirque	m
citation	f
cité	f
citoyenneté	f
civil	m
civilisation	f
clan	m
clarté	f
classe	f
classement	m
clause	f
clé	f
clef	f
cliché	m
client	m
clientèle	f
climat	m
clinique	f
cloche	f
clonage	m
clôture	f
club	m
coalition	f
cochon	m
cocktail	m
code	m
coffre	m
cohérence	f
cohésion	f
coin	m
coïncidence	f
col	m
colère	f
colisée	m
collaborateur	m
collaboration	f
collection	f
collectivité	f
collège	m
colline	f
colonel	m
colonie	f
colonne	f
combat	m
combattant	m
combinaison	f
comble	m
combustible	m
comédie	f
comédien	m
comité	m
commandant	m
commande	f
commandement	m
commencement	m
commentaire	m
commerçant	m
commerce	m
commissariat	m
commission	f
communauté	f
commune	f
communication	f
communiqué	m
communisme	m
compagnie	f
compagnon	m
comparaison	f
compassion	f
compensation	f
compétence	f
compétition	f
compétitivité	f
complément	m
complexité	f
complicité	f
compliment	m
complot	m
comportement	m
composant	m
composante	f
composition	f
compréhension	f
compression	f
compromis	m
comptabilité	f
comptable	m
compte	m
comte	m
comté	m
concentration	f
concept	m
conception	f
concert	m
concertation	f
concession	f
concitoyen	m
conclusion	f
concours	m
concurrence	f
concurrent	m
condamnation	f
condition	f
conducteur	m
conduite	f
confédération	f
conférence	f
confession	f
confiance	f
configuration	f
confirmation	f
conflit	m
conformité	f
confort	m
confrère	m
confrontation	f
confusion	f
congé	m
congrès	m
conjoint	m
conjoncture	f
connaissance	f
connerie	f
connexion	f
conquête	f
conscience	f
conseil	m
consensus	m
consentement	m
conséquence	f
conservation	f
considération	f
consigne	f
consommateur	m
consommation	f
constat	m
constitution	f
constructeur	m
construction	f
consultation	f
contact	m
conte	m
contenu	m
contestation	f
contexte	m
continent	m
contingent	m
continuité	f
contradiction	f
contrainte	f
contraire	m
contrat	m
contrepartie	f
contribution	f
contrôle	m
contrôleur	m
controverse	f
convention	f
conversation	f
conversion	f
conviction	f
convoi	m
coopération	f
coordination	f
copain	m
copie	f
corde	f
cordon	m
corps	m
correction	f
correspondance	f
correspondant	m
corruption	f
costume	m
cote	f
côte	f
côté	m
cotisation	f
coton	m
cou	m
couche	f
coude	m
couleur	f
coulisse	f
couloir	m
coup	m
coupe	f
couple	m
coupure	f
cour	m
courage	m
courbe	f
couronne	f
courrier	m
cours	m
course	f
cousin	m
coût	m
couteau	m
coutume	f
couvert	m
couverture	f
crainte	f
crâne	m
créateur	m
création	f
créature	f
crédibilité	f
crédit	m
crème	f
crête	f
creux	m
cri	m
crime	m
criminalité	f
criminel	m
crise	f
critère	m
croisière	f
croissance	f
croix	f
croyance	f
cruauté	f
cuiller	f
cuisine	f
cul	m
culpabilité	f
culte	m
culture	f
curé	m
curiosité	f
cycle	m
dame	f
danger	m
danse	f
danseur	m
date	f
débat	m
débit	m
débouché	m
début	m
décennie	f
déception	f
décès	m
déchet	m
décision	f
déclaration	f
déclin	m
décor	m
découverte	f
décret	m
défaillance	f
défaite	f
défaut	m
défense	f
défi	m
déficit	m
définition	f
dégât	m
dégradation	f
degré	m
délai	m
délégation	f
délégué	m
délibération	f
délit	m
demande	f
demandeur	m
démarche	f
démarrage	m
demeure	f
demi	m
demi-heure	f
démission	f
démocratie	f
démon	m
démonstration	f
dénonciation	f
dent	f
départ	m
département	m
dépendance	f
dépens	m
dépense	f
dépit	m
déplacement	m
déploiement	m
dépôt	m
dépression	f
député	m
dérive	f
déroulement	m
désaccord	m
désarmement	m
désastre	m
descente	f
description	f
déséquilibre	m
désert	m
désespoir	m
désignation	f
désir	m
désordre	m
dessin	m
destin	m
destination	f
destinée	f
destruction	f
détachement	m
détail	m
détente	f
détenteur	m
détention	f
détenu	m
détérioration	f
détermination	f
détour	m
détresse	f
détriment	m
dette	f
deuil	m
développement	m
devise	f
diable	m
diagnostic	m
dialogue	m
diamant	m
dictateur	m
dictature	f
dictionnaire	m
dieu	m
différence	f
différend	m
difficulté	f
diffusion	f
dignité	f
dilemme	m
dimension	f
diminution	f
diplomatie	f
diplôme	m
directeur	m
direction	f
directive	f
dirigeant	m
discipline	f
discours	m
discrétion	f
discrimination	f
discussion	f
disparition	f
disponibilité	f
dispositif	m
disposition	f
disque	m
distance	f
distinction	f
distorsion	f
distributeur	m
distribution	f
divergence	f
diversité	f
division	f
divorce	m
dizaine	f
docteur	m
doctrine	f
document	m
documentation	f
doigt	m
dollar	m
domaine	m
domicile	m
domination	f
dommage	m
don	m
donnée	f
dos	m
dose	f
dossier	m
douane	f
douanier	m
douceur	f
douleur	f
doute	m
douzaine	f
drame	m
drap	m
drapeau	m
drogue	f
droit	m
droite	f
dû	m
duc	m
durée	f
dynamisme	m
eau	f
écart	m
échange	m
échantillon	m
échéance	f
échec	m
échelle	f
échelon	m
écho	m
éclat	m
école	f
économie	f
écoute	f
écran	m
écrit	m
écriture	f
écrivain	m
écu	m
édifice	m
éditeur	m
édition	f
éducation	f
effet	m
efficacité	f
effondrement	m
effort	m
égalité	f
égard	m
église	f
élaboration	f
élan	m
élargissement	m
électeur	m
élection	f
électricité	f
élément	m
élimination	f
élite	f
éloge	m
embargo	m
embauche	f
émetteur	m
émeute	f
émission	f
émotion	f
empereur	m
empire	m
emplacement	m
emploi	m
employé	m
employeur	m
empreinte	f
emprunt	m
encadrement	m
encouragement	m
endroit	m
énergie	f
enfance	f
enfer	m
engagement	m
engin	m
enjeu	m
ennemi	m
ennui	m
enquête	f
enquêteur	m
enregistrement	m
enseignant	m
enseignement	m
entente	f
enthousiasme	m
entité	f
entourage	m
entraînement	m
entraîneur	m
entrée	f
entrepreneur	m
entreprise	f
entretien	m
entrevue	f
enveloppe	f
envergure	f
envie	f
environnement	m
envoi	m
épargne	f
épaule	f
épicerie	f
épidémie	f
épisode	m
époque	f
époux	m
épreuve	f
équation	f
équilibre	m
équipage	m
équipe	f
équipement	m
équité	f
ère	f
erreur	f
escabeau	m
escalier	m
esclavage	m
esclave	m
espace	m
espèce	f
espérance	f
espoir	m
esprit	m
essai	m
essence	f
essor	m
estimation	f
estomac	m
établissement	m
étage	m
étape	f
état	m
état-major	m
été	m
étendue	f
étiquette	f
étoile	f
étranger	m
étude	f
étudiant	m
euro	m
évaluation	f
évasion	f
événement	m
éventail	m
éventualité	f
évêque	m
évidence	f
évolution	f
examen	m
excédent	m
excellence	f
exception	f
excès	m
exclu	m
exclusion	f
excuse	f
exécution	f
exemplaire	m
exemple	m
exercice	m
exigence	f
exil	m
existence	f
exode	m
expansion	f
expédition	f
expérience	f
expert	m
expertise	f
explication	f
exploit	m
exploitation	f
exploration	f
explosion	f
exportation	f
exposé	m
exposition	f
expression	f
extension	f
extérieur	m
extraction	f
extrait	m
extrémité	f
fabricant	m
fabrication	f
façade	f
face	f
facilité	f
façon	f
facteur	m
facture	f
faculté	f
faiblesse	f
faille	f
faillite	f
faim	f
faisceau	m
fait	m
famille	f
famine	f
fantôme	m
farce	f
fardeau	m
fatigue	f
faute	f
fauteuil	m
faveur	f
fédération	f
félicitation	f
femme	f
fenêtre	f
fer	m
fermeté	f
fermeture	f
fermier	m
festival	m
fête	f
feu	m
feuille	f
fève	f
fiche	f
fichier	m
fiction	f
fidélité	f
fierté	f
fièvre	f
figure	f
fil	m
file	f
filet	m
fille	f
fillette	f
film	m
fils	m
fin	f
finale	f
finance	f
financement	m
firme	f
fixation	f
flamme	f
fléau	m
flèche	f
fleur	f
fleuve	m
flot	m
flotte	f
flux	m
foi	f
foie	m
foire	f
fois	f
folie	f
fonction	f
fonctionnement	m
fond	m
fondateur	m
fondation	f
fondement	m
fonds	m
football	m
force	f
forêt	f
formalité	f
format	m
formation	f
forme	f
formule	f
fortune	f
forum	m
fossé	m
foudre	f
fouet	m
foule	f
fournisseur	m
fourniture	f
foyer	m
fraction	f
franchise	f
frappe	f
fraude	f
frein	m
fréquence	f
frère	m
froid	m
fromage	m
front	m
frontière	f
fruit	m
frustration	f
fuite	f
fumée	f
fusil	m
fusion	f
futur	m
gagnant	m
gain	m
galerie	f
gamin	m
gamme	f
garage	m
garantie	f
garçon	m
garde	m
gardien	m
gare	f
gars	m
gâteau	m
gaz	m
gazelle	f
géant	m
gel	m
gendarmerie	f
gène	m
génération	f
générosité	f
génie	m
génocide	m
genou	m
genre	m
geste	m
gestion	f
glace	f
glissement	m
globe	m
gloire	f
golf	m
golfe	m
gorge	f
gorille	m
goût	m
goutte	f
gouvernement	m
gouverneur	m
grâce	f
grain	m
grandeur	f
grand-mère	f
grand-père	m
gravité	f
gré	m
grève	f
grille	f
grossesse	f
groupe	m
groupement	m
guerre	f
guerrier	m
gueule	f
guise	f
habitant	m
habitation	f
habitude	f
haine	f
hall	m
handicap	m
harmonie	f
harmonisation	f
hasard	m
hâte	f
hausse	f
hauteur	f
hélicoptère	m
hépatite	f
herbe	f
héritage	m
héritier	m
héroïne	f
héros	m
hésitation	f
heure	f
hiérarchie	f
histoire	f
historien	m
hiver	m
hommage	m
homme	m
honneur	m
honte	f
hôpital	m
horaire	m
horizon	m
horreur	f
hostilité	f
hôte	m
hôtel	m
huile	f
humain	m
humanité	f
humeur	f
humour	m
hymne	m
hypothèse	f
idée	f
identification	f
identité	f
idéologie	f
ignorance	f
île	f
illusion	f
illustration	f
image	f
imagination	f
immeuble	m
immigration	f
impact	m
impasse	f
impatience	f
implantation	f
implication	f
importance	f
importation	f
imposition	f
impossibilité	f
impôt	m
impression	f
impulsion	f
incapacité	f
incendie	m
incertitude	f
incidence	f
incident	m
incitation	f
inconvénient	m
indemnisation	f
indépendance	f
indicateur	m
indication	f
indice	m
indifférence	f
individu	m
industrie	f
inégalité	f
infini	m
infirmier	m
inflation	f
influence	f
information	f
infraction	f
infrastructure	f
initiative	f
injustice	f
innocence	f
innovation	f
inondation	f
inquiétude	f
inscription	f
inspecteur	m
inspection	f
inspiration	f
instabilité	f
installation	f
instance	f
instant	m
instinct	m
institut	m
instituteur	m
institution	f
instruction	f
instrument	m
insuffisance	f
insulte	f
intégration	f
intégrité	f
intelligence	f
intensité	f
intention	f
interaction	f
interdiction	f
intérêt	m
interface	f
intérieur	m
interlocuteur	m
interprétation	f
interrogation	f
interruption	f
intervalle	m
intervenant	m
intervention	f
interview	f
intimité	f
introduction	f
invasion	f
invention	f
investissement	m
investisseur	m
invitation	f
invité	m
ironie	f
Islam	m
isolement	m
issue	f
jambe	f
jardin	m
jet	m
jeu	m
jeunesse	f
joie	f
joue	f
jouet	m
joueur	m
jour	m
journal	m
journée	f
jugement	m
jumeau	m
jungle	f
juridiction	f
jury	m
justesse	f
justice	f
justification	f
kilo	m
kilomètre	m
laboratoire	m
lac	m
lacune	f
lait	m
lampe	f
lance	f
lancement	m
langage	m
langue	f
larme	f
leader	m
leadership	m
leçon	f
lecteur	m
lecture	f
légende	f
légion	f
législation	f
législature	f
légitimité	f
légume	m
lettre	f
levée	f
lèvre	f
liaison	f
libéralisation	f
libération	f
liberté	f
librairie	f
libre-échange	m
licence	f
licenciement	m
lien	m
lieu	m
lieutenant	m
ligne	f
limitation	f
limite	f
liste	f
lit	m
litre	m
littérature	f
livraison	f
livre	m
localité	f
location	f
logement	m
logiciel	m
logique	f
loi	f
loisir	m
longueur	f
lot	m
loup	m
loyer	m
lumière	f
lune	f
lunette	f
lutte	f
luxe	m
lycée	m
lynx	m
machine	f
madame	f
mademoiselle	f
magasin	m
magasinage	m
magazine	m
magistrat	m
main	f
maintenance	f
maintien	m
maire	m
mairie	f
maison	f
maître	m
maîtrise	f
majesté	f
majorité	f
maladie	f
malaise	m
malentendu	m
malheur	m
maman	f
manche	m
mandat	m
manière	f
manifestant	m
manifestation	f
manipulation	f
manouvre	f
manque	m
manteau	m
marchand	m
marchandise	f
marche	f
marché	m
marée	f
marge	f
mari	m
mariage	m
marin	m
marine	f
mark	m
marque	f
masque	m
massacre	m
masse	f
match	m
matériau	m
matériel	m
maternité	f
matière	f
matin	m
matinée	f
mec	m
mécanisme	m
mécontentement	m
médaille	f
médecin	m
médecine	f
médiation	f
médicament	m
méfiance	f
mélange	m
membre	m
mémoire	f
menace	f
ménage	m
mensonge	m
mentalité	f
mention	f
menu	m
mépris	m
mer	f
merde	f
mère	f
mérite	m
merveille	f
message	m
messe	f
mesure	f
métal	m
météo	f
méthode	f
métier	m
mètre	m
métro	m
meuble	m
meurtre	m
meurtrier	m
micro	m
midi	m
milice	f
milieu	m
mille	m
millénaire	m
milliard	m
millier	m
million	m
mine	f
ministère	m
minorité	f
minuit	m
minute	f
miracle	m
miroir	m
mise	f
misère	f
missile	m
mission	f
mobile	m
mobilisation	f
mobilité	f
modalité	f
mode	m
modèle	m
modernisation	f
modification	f
moine	m
mois	m
moitié	f
moment	m
monde	m
mondialisation	f
monnaie	f
monopole	m
monsieur	m
monstre	m
montage	m
montagne	f
montant	m
montée	f
montre	f
monument	m
moral	m
morale	f
morceau	m
mortalité	f
mot	m
moteur	m
motif	m
motion	f
motivation	f
mouton	m
mouvement	m
moyen	m
moyenne	f
multiplication	f
municipalité	f
munition	f
mur	m
musée	m
musicien	m
musique	f
mutation	f
mystère	m
mythe	m
nage	f
naissance	f
nation	f
nationalité	f
nature	f
navette	f
navigation	f
navire	m
néant	m
nécessité	f
négociateur	m
négociation	f
neige	f
nettoyage	m
nez	m
niveau	m
noix	f
nom	m
nombre	m
nomination	f
norme	f
note	f
notion	f
noud	m
nourriture	f
nouveauté	f
noyau	m
nuage	m
nuance	f
nuit	f
numéro	m
oasis	f
objectif	m
objection	f
objet	m
obligation	f
obscurité	f
observateur	m
observation	f
obsession	f
obstacle	m
obtention	f
occasion	f
occupation	f
occurrence	f
océan	m
odeur	f
oeuf	m
offensive	f
office	m
offre	f
oil	m
oiseau	m
ombre	f
oncle	m
onde	f
opéra	m
opérateur	m
opération	f
opinion	f
opportunité	f
opposition	f
optimisme	m
option	f
or	m
orage	m
orange	f
orchestre	m
ordinateur	m
ordonnance	f
ordre	m
oreille	f
organe	m
organisateur	m
organisation	f
organisme	m
orgueil	m
orientation	f
origine	f
os	m
otage	m
oubli	m
ouf	m
ours	m
outil	m
ouverture	f
ouvrage	m
ouvre	f
ouvrier	m
pacte	m
page	f
paiement	m
pain	m
pair	m
paire	f
paix	f
palais	m
palier	m
panier	m
panne	f
panneau	m
pantalon	m
papa	m
pape	m
papier	m
paquet	m
paradis	m
paradoxe	m
paragraphe	m
paramètre	m
parapluie	m
parc	m
parcours	m
pardon	m
parenthèse	f
parfum	m
pari	m
parlement	m
parole	f
parquet	m
part	f
partage	m
partenariat	m
parti	m
participant	m
participation	f
partie	f
partisan	m
passage	m
passager	m
passe	f
passé	m
passeport	m
passion	f
pasteur	m
pâte	f
patience	f
patient	m
patinage	m
patrie	f
patrimoine	m
patron	m
patte	f
pause	f
pauvreté	f
pavillon	m
pays	m
paysage	m
paysan	m
peau	f
pêche	f
péché	m
pêcheur	m
peine	f
peintre	m
peinture	f
pèlerinage	m
pendaison	f
pensée	f
pension	f
pente	f
pénurie	f
perception	f
perdant	m
père	m
performance	f
péril	m
période	f
permanence	f
permis	m
permission	f
personnage	m
personnalité	f
personne	f
perspective	f
perte	f
perturbation	f
pétition	f
pétrole	m
pétrolier	m
peuple	m
peur	f
phare	m
pharmacie	f
phase	f
phénomène	m
philosophie	f
photo	f
photographie	f
phrase	f
piano	m
pièce	f
pied	m
piège	m
pierre	f
pile	f
pilier	m
piste	f
pitié	f
pizza	f
place	f
placement	m
plafond	m
plage	f
plaie	f
plainte	f
plaisir	m
plan	m
planche	f
plancher	m
planète	f
planification	f
plante	f
plaque	f
plat	m
plateau	m
plate-forme	f
plomb	m
pluie	f
plume	f
plupart	f
pneu	m
poche	f
poème	m
poésie	f
poète	m
poids	m
poignée	f
poil	m
poing	m
point	m
pointe	f
poisson	m
poitrine	f
pôle	m
police	f
policier	m
politique	f
polka	f
pollution	f
pomme	f
pompe	f
pompier	m
pont	m
population	f
porc	m
port	m
porte	f
portée	f
portefeuille	m
porteur	m
portion	f
portrait	m
position	f
possession	f
possibilité	f
poste	m
pot	m
poteau	m
poubelle	f
pouce	m
poudre	f
poule	f
poulet	m
poumon	m
pourcentage	m
poursuite	f
poussée	f
poussière	f
poutrelle	f
pratique	f
précaution	f
précipitation	f
précision	f
prédécesseur	m
préférence	f
préfet	m
préjudice	m
préjugé	m
prélèvement	m
prénom	m
préoccupation	f
préparation	f
présence	f
présentation	f
présidence	f
président	m
presse	f
pression	f
prestation	f
prétention	f
prétexte	m
prêtre	m
preuve	f
prévention	f
prévision	f
prière	f
prime	f
prince	m
princesse	f
principe	m
printemps	m
priorité	f
prise	f
prison	f
prisonnier	m
privatisation	f
privilège	m
prix	m
probabilité	f
problème	m
procédé	m
procédure	f
procès	m
processus	m
procès-verbal	m
procureur	m
producteur	m
production	f
productivité	f
produit	m
profession	f
profil	m
profit	m
profondeur	f
programmation	f
programme	m
progrès	m
progression	f
proie	f
projection	f
projet	m
promesse	f
promoteur	m
promotion	f
propagande	f
propagation	f
prophète	m
proportion	f
propos	m
proposition	f
propriété	f
prospérité	f
prostitution	f
protection	f
protestation	f
protocole	m
provenance	f
province	f
provision	f
provocation	f
proximité	f
prudence	f
psychologie	f
public	m
publication	f
publicité	f
puissance	f
puits	m
punition	f
putain	f
quai	m
qualification	f
qualité	f
quantité	f
quarantaine	f
quart	m
quartier	m
querelle	f
question	f
quête	f
queue	f
quinzaine	f
quota	m
race	f
racine	f
racisme	m
radio	f
rage	f
rail	m
raison	f
raisonnement	m
ralentissement	m
rang	m
rapidité	f
rappel	m
rapport	m
rapporteur	m
rapprochement	m
rassemblement	m
rat	m
râteau	m
ratification	f
rayon	m
rayonnement	m
réacteur	m
réaction	f
réalisateur	m
réalisation	f
réalité	f
rébellion	f
récepteur	m
réception	f
récession	f
recette	f
recherche	f
récit	m
récolte	f
recommandation	f
récompense	f
réconciliation	f
reconnaissance	f
reconstruction	f
record	m
recours	m
recrutement	m
reçu	m
recul	m
récupération	f
rédacteur	m
rédaction	f
redressement	m
réduction	f
réduit	m
référence	f
référendum	m
reflet	m
réflexe	m
réflexion	f
réforme	f
refuge	m
refus	m
regard	m
régime	m
régiment	m
région	f
registre	m
règle	f
règlement	m
réglementation	f
règne	m
regret	m
regroupement	m
reine	f
rejet	m
relais	m
relance	f
relation	f
relevé	m
religion	f
remarque	f
remboursement	m
remède	m
remise	f
remplacement	m
rémunération	f
rencontre	m
rendement	m
rendez-vous	m
renforcement	m
renfort	m
renouveau	m
renouvellement	m
rénovation	f
renseignement	m
rentabilité	f
rente	f
rentrée	f
renvoi	m
réparation	f
répartition	f
repas	m
répercussion	f
repère	m
répétition	f
repli	m
réplique	f
réponse	f
report	m
reportage	m
repos	m
représentant	m
représentation	f
répression	f
reprise	f
reproche	m
reproduction	f
république	f
réputation	f
requête	f
réseau	m
réserve	f
réservoir	m
résidence	f
résident	m
résistance	f
résolution	f
respect	m
responsabilité	f
ressort	m
ressource	f
restaurant	m
restauration	f
reste	m
restriction	f
restructuration	f
résultat	m
rétablissement	m
retard	m
retenue	f
réticence	f
retombée	f
retour	m
retrait	m
retraite	f
réunion	f
réussite	f
revanche	f
rêve	m
réveil	m
révélation	f
revendication	f
revenu	m
revers	m
révision	f
révolte	f
révolution	f
revue	f
richesse	f
rideau	m
rigueur	f
risque	m
rivage	m
rive	f
rivière	f
robe	f
rocher	m
rock	m
roi	m
rôle	m
roman	m
romancier	m
roue	f
route	f
routier	m
routine	f
royaume	m
rubrique	f
rue	f
ruine	f
rumeur	f
rupture	f
rythme	m
sac	m
sacrifice	m
saga	f
sagesse	f
saison	f
salaire	m
salarié	m
salaud	m
salle	f
salon	m
salsa	f
sanction	f
sang	m
santé	f
satellite	m
satisfaction	f
saut	m
sauvetage	m
scandale	m
scénario	m
scène	f
scepticisme	m
schéma	m
science	f
score	m
scrutin	m
séance	f
sécheresse	f
seconde	f
secours	m
secret	m
secrétariat	m
secteur	m
section	f
sécurité	f
seigneur	m
sein	m
séjour	m
sel	m
sélection	f
semaine	f
semblant	m
semestre	m
séminaire	m
sénateur	m
sens	m
sensation	f
sensibilité	f
sentiment	m
séparation	f
séquence	f
sérénité	f
série	f
serment	m
serre	f
serveur	m
service	m
session	f
seuil	m
sexe	m
siècle	m
siège	m
signal	m
signature	f
signe	m
signification	f
silence	m
sillage	m
simplicité	f
sincérité	f
singe	m
sinistre	m
site	m
situation	f
ski	m
slogan	m
socialisme	m
société	f
soda	m
soif	f
soin	m
soir	m
soirée	f
sol	m
soldat	m
solde	f
soleil	m
solidarité	f
solitude	f
solution	f
somme	f
sommeil	m
sommet	m
sondage	m
sorcier	m
sort	m
sorte	f
sortie	f
sou	m
souci	m
souffle	m
souffrance	f
souhait	m
soulagement	m
soumission	f
soupçon	m
soupe	f
souplesse	f
sour	f
source	f
souris	f
sous-marin	m
sous-sol	m
soutien	m
souverain	m
souveraineté	f
soya	m
spécialité	f
spécification	f
spectacle	m
spectateur	m
spectre	m
spéculation	f
sphère	f
sport	m
stabilisation	f
stabilité	f
stade	m
stage	m
star	f
station	f
statistique	f
statue	f
statut	m
stock	m
stratégie	f
stress	m
structure	f
studio	m
stupéfiant	m
style	m
substance	f
substitution	f
subvention	f
succès	m
successeur	m
succession	f
sucre	m
suffrage	m
suggestion	f
suicide	m
suite	f
sujet	m
supplément	m
support	m
suppression	f
surcroît	m
sûreté	f
surface	f
surplus	m
surprise	f
sursis	m
surveillance	f
survie	f
suspect	m
suspens	m
suspension	f
symbole	m
sympathie	f
symptôme	m
syndicat	m
syndrome	m
synthèse	f
système	m
tabac	m
table	f
tableau	m
tache	f
tâche	f
tactique	f
taille	f
talent	m
tante	f
tapioca	m
tapis	m
tarif	m
tas	m
taux	m
taxe	f
taxi	m
technicien	m
technique	f
technologie	f
télé	f
télécommunication	f
téléphone	m
téléspectateur	m
télévision	f
témoignage	m
témoin	m
température	f
tempête	f
temple	m
temps	m
tenant	m
tendance	f
tendresse	f
teneur	f
tennis	m
tension	f
tentation	f
tentative	f
tente	f
tenue	f
terme	m
terminaison	f
terminal	m
terrain	m
terre	f
terreur	f
territoire	m
terrorisme	m
test	m
tête	f
texte	m
textile	m
thé	m
théâtre	m
thème	m
théologie	f
théorie	f
thérapie	f
thèse	f
timbre	m
tir	m
tirage	m
tissu	m
titre	m
toile	f
toilette	f
toit	m
tolérance	f
tombe	f
tonne	f
tort	m
torture	f
totalité	f
touche	f
tour	m
tourisme	m
tournant	m
tournée	f
tournoi	m
toux	f
trace	f
tradition	f
traduction	f
trafic	m
tragédie	f
trahison	f
train	m
trait	m
traite	f
traité	m
traitement	m
trajet	m
trame	f
tranche	f
transaction	f
transfert	m
transformation	f
transit	m
transition	f
transmission	f
transparence	f
transport	m
travail	m
travailleur	m
traversée	f
tremblement	m
trentaine	f
trésor	m
trêve	f
tribu	f
tribunal	m
tribune	f
trimestre	m
triomphe	m
tristesse	f
trône	m
trophée	m
trottoir	m
trou	m
trouble	m
troupe	f
troupeau	m
truc	m
tube	m
tueur	m
tunnel	m
type	m
unanimité	f
union	f
unité	f
univers	m
université	f
uranium	m
urgence	f
usage	m
usager	m
usine	f
utilisateur	m
utilisation	f
utilité	f
vacance	f
vacances	f
vache	f
vague	f
vaisseau	m
valeur	f
valise	f
vallée	f
vapeur	f
variation	f
variété	f
vedette	f
véhicule	m
veille	f
veillée	f
vélo	m
vendeur	m
vengeance	f
vent	m
vente	f
ventre	m
venue	f
verdict	m
vérificateur	m
vérification	f
vérité	f
vermicelle	m
verre	m
versant	m
versement	m
version	f
vertu	f
vertue	f
vêtement	m
veuf	m
veuve	f
viande	f
vice	m
vice-président	m
victime	f
victoire	f
vidéo	f
vie	f
vieillard	m
vieillesse	f
vierge	f
vigilance	f
vigueur	f
villa	f
village	m
ville	f
vin	m
vingtaine	f
viol	m
violation	f
violence	f
virus	m
vis	f
visa	m
visage	m
visée	f
vision	f
visite	f
visiteur	m
vitesse	f
vitre	f
vitrine	f
vocabulaire	m
vocation	f
voie	f
voile	m
voisin	m
voisinage	m
voiture	f
voix	f
vol	m
volant	m
volet	m
voleur	m
volonté	f
volume	m
vote	m
vou	m
voyage	m
voyageur	m
vue	f
week-end	m
yen	m
yoga	m
zéro	m
zone	f